NO ./pngs/texture_no.png
SO ./pngs/texture_so.png
WE ./pngs/texture_es.png
EA ./pngs/texture_ws.png

C 225,30,0
F 220,100,0

11111111111111
      10001       
     110N11
     111111