NO ./pngs/texture_no.png
SO ./pngs/texture_so.png
WE ./pngs/texture_es.png
EA ./pngs/texture_ws.png

F 0,100,0
C 173,216,230
 
1111
1001
1N01
1111