1111111111
1001000001
1001000001
1001001001
1001001001
1001001001
1NN1111001
1000000001
1000000001
1111111111
